Taped for extended durability=缠胶带延长耐久度
Barbed for extra damage=带倒刺造成额外伤害
High Stamina Usage=高耐力消耗
Low Stamina Usage=低耐力消耗
Doesn't deal a lot of damage to crates=对板条箱伤害较低
Very weak damage on crates=对板条箱伤害极低
Effective at destroying crates=能有效破坏板条箱
Extremely effective at destroying crates=对板条箱破坏力极强
Can do a heavy attack=可重击
Primary attack only=仅有主攻击
Primary does a lot of damage=主攻击伤害高
Primary doesn't do much damage=主攻击伤害低
Has good durability=耐久度良好
Cannot be broken=无法损坏
Moderate durability=耐久度中等
Not very durable=耐久度较差
Weapon is about to break!=武器即将损坏！
Great swing range=挥动范围大
Low swing range=挥动范围小
If broken, repair with=若损坏需用
Can be combined with=（可组合）与
Adds temporary immunity to most negative madness effects=提供对多数负面癫狂效果的暂时免疫
Permanent stamina boost=永久提升耐力
Temporarily stops hunger ailments=暂时抑制饥饿
Can be used as a throwable=可作为投掷物使用
- Can be used as a throwable=- Can be used as a throwable=- 可作为投掷物使用=- 可作为投掷物使用
Spark to light up dark spaces=火花可照亮黑暗空间
Can be used to ignite some crafted items=可用于点燃某些手工制品
Lights up dark spaces for roughly 30 seconds=照亮黑暗空间约30秒
Can be used when submerged in water=可在水下使用
Can hold up to 8 bullets=最多可装8发子弹
Deals a great amount of damage=造成大量伤害
Can hold up to 32 bullets=最多可装32发子弹
Deals a moderate amount of damage=造成中等伤害
Fire in short bursts=短促点射
Close range=近距离
Deals a significant amount of damage=造成显著伤害
Takes time to reload after each shot=每次射击后需时间装填
Large amount of shot spread=弹丸散布范围大
Mid range=中距离
Deals a moderate amount of damage=造成中等伤害
Can hold up to 5 shells=最多可装5发弹壳
Moderate amount of shot spread=弹丸散布范围中等
Fires one harpoon at a time=每次发射一支鱼叉
Can impale into monsters=可刺入怪物体内
Very slow reload time=装填速度极慢
Fired harpoon can sometimes break=发射的鱼叉有时会损坏
Can hold up to 6 rounds=最多可装6发弹药
Deals a large amount of damage=造成巨大伤害
Ammo for a firearm=枪械弹药
Wearable armor=可穿戴护甲
Absorbs 20% of damage=吸收20%伤害
Reduces bleed risk by half=流血风险减半
Armor is ruined and ineffective!=护甲已损毁失效！
Armor is almost ruined=护甲即将损毁
Absorbs 50% of damage=吸收50%伤害
Extremely low bleed risk=极低流血风险
Higher max weight=更高最大负重
Heats food=加热食物
Sanitizes bad food=净化变质食物
Use to save progress=用于保存进度
Causes heavy bleeding=导致严重流血
Causes bleeding=导致流血
Causes minor bleeding=导致轻微流血
Reduces 3 bars of bleed=减少3格流血值
Reduces 2 bars of bleed=减少2格流血值
Reduces 1 bar of bleed=减少1格流血值
Reduces bleeding=减轻流血
Heals 3 bars of health=恢复3格生命值
Heals 2 bars of health=恢复2格生命值
Heals 1 bar of health=恢复1格生命值
Minor healing=轻微治疗
Reduces health=降低生命值
Reduces health significantly=显著降低生命值
Causes extreme hunger=导致极度饥饿
Causes hunger=导致饥饿
Causes minor hunger=导致轻微饥饿
Reduces 3 bars of hunger=减少3格饥饿值
Reduces 2 bars of hunger=减少2格饥饿值
Reduces 1 bar of hunger=减少1格饥饿值
+ Reduces 1 bar of hunger=+ Reduces 1 bar of hunger=+ 减少1格饥饿值=+ 减少1格饥饿值
Reduces hunger=减轻饥饿
Increases 4 bars of Madness=增加4格癫狂值
Increases 3 bars of Madness=增加3格癫狂值
Increases 2 bars of Madness=增加2格癫狂值
Increases 1 bar of Madness=增加1格癫狂值
Causes minor Madness increase=轻微增加癫狂值
Reduces Madness=减轻癫狂
Reduces 1 bar of Madness=减少1格癫狂值
Reduces 1 bars of Madness=减少1格癫狂值
Gives a big energy boost=大幅提升体力
Gives an energy boost=提升体力
Reduces any energy boosts=降低所有体力增益
Significantly reduces boosts=显著降低体力增益
Boost allows faster attacks=体力允许更快攻击
CHAPTER =章节 
Heals 4 bars of health=恢复4格生命值
Heals 5 bars of health=恢复5格生命值
Heals 6 bars of health=恢复6格生命值
Reduces 4 bars of bleed=减少4格流血值
Reduces 5 bars of bleed=减少5格流血值
Reduces 6 bars of bleed=减少6格流血值
Reduces 4 bars of hunger=减少4格饥饿值
Reduces 5 bars of hunger=减少5格饥饿值
Reduces 6 bars of hunger=减少6格饥饿值
Increases Madness=增加癫狂值
COMBINE TO MAKE =组合制作 
Upgraded =升级 
Use =使用 
Needs =需要 
Requires =需要 
 needed...= 需要...
Missing =缺少 
Read Journal: =阅读日志：
 remaining= 剩余
Powering up: =启动中：
Keep this resolution?\nSetting will revert in =保持此分辨率？\n设置将于 
Keep this resolution?\nSetting will revert in =保持此分辨率？\n设置将于 
 seconds...= 秒后恢复...
 second...= 秒后恢复...
Erase Save =删除存档 
Override Save =覆盖存档 
New Save =新建存档 
ARRIVAL=抵达
DECAY=腐朽
FORGOTTEN=遗忘
STORM=风暴
CROSSROADS=十字路口
REGRESSION=回溯
MADNESS=癫狂
CHAOS=混沌
RESOLVE=决意
Door 237=237号门
Returning Contract=回归契约
They're Gone=他们消失了
Prescription=处方单
Doctor Thomas=托马斯医生
The Note=那张字条
Treatment Options=治疗方案
Message=留言
Utility Tunnels=公用隧道
Garbage=垃圾区
Feeling Blue?=心情低落？
Letter from Alistar=阿利斯塔的来信
Letter to Leda=致莱达的信
Leda=莱达
Reaching Out=伸出援手
Faces=面孔
Cora=科拉
Information Request=信息查询
They Left=他们离开了
Leda's Ferry Ticket=莱达的渡轮船票
Confession=忏悔录
Leanne Mills=莉安·米尔斯
New Apartment=新公寓
Instructions 1=指示1
Instructions 2=指示2
Resignation=辞职信
Ferry Ticket=渡轮船票
Follow Up=后续跟进
Isolation=隔离
Library Note=图书馆便条
Ticket Home=回家车票
Lease=租约
Rescue=救援
I Need Help=我需要帮助
Washed Up=搁浅
Happy Place?=快乐之地？
Lasting Changes=永久改变
A note=一张字条
Catacombs Map North=地下墓穴北区地图
Catacombs Map South=地下墓穴南区地图
Celebrations=庆典
Radio Recording=无线电录音
Radiation Notice=辐射通知
Switch Order=开关顺序
Forest Map=森林地图
SMG BULLETS=冲锋枪子弹
REVOLVER BULLETS=左轮子弹
HARPOON=鱼叉
PISTOL MAGAZINE=手枪弹匣
SHOTGUN SHELLS=霰弹枪子弹
WEIGHT SKELETON=承重骨架
MINER ARMOR=矿工护甲
POLICE VEST=警用背心
AXE HEAD=斧头
BARBED WIRE=带刺铁丝
BRITTLE TAPE=脆裂胶带
BROKEN BUTCHER KNIFE=破损的屠刀
BROKEN KNIFE=破损的刀
CHAIN=锁链
CLOTH=布料
COMPOUND GR-72K=GR-72K化合物
COMPOUND SERO-33=SERO-33化合物
COMPOUND SMI-1=SMI-1化合物
COMPOUND SMI-2=SMI-2化合物
COMPOUND STAMINA-K=体力-K化合物
HAMMER HEAD=锤头
KNIFE REPAIR KIT=刀具维修包
LIGHTER FLUID=打火机油
NAIL BOX=钉子盒
PICKAXE HEAD=镐头
RAG=破布
METAL SHARD=金属碎片
SLEDGEHAMMER HEAD=大锤头
SMALL WOODEN HANDLE=小木柄
SPADE HEAD=铲头
STRING SPOOL=线轴
TAPE=胶带
WOOD GLUE=木工胶
ARMY RATIONS=军用口粮
MONSTER MEAT=怪物肉
EMPTY BOTTLE=空瓶
ENERGY DRINK=能量饮料
GAS COOKER=燃气灶
GOOD BREAD=优质面包
MEAT CAN=肉罐头
ROTTEN APPLE=腐烂苹果
ROTTING BREAD=发霉面包
ROTTING MEAT=腐肉
SALAMI=萨拉米
TUNA CAN=金枪鱼罐头
VODKA=伏特加
CLEAN WATER=洁净水
DIRTY WATER=污水
WHISKEY=威士忌
HEATED ARMY RATIONS=加热军用口粮
COOKED MONSTER MEAT=熟怪物肉
TOAST=吐司
HEATED MEAT CAN=加热肉罐头
OLD TOAST=陈年吐司
COOKED ROTTING MEAT=熟腐肉
HEATED SALAMI=加热萨拉米
HEATED TUNA CAN=加热金枪鱼罐头
BANDAGES=绷带
BLOOD CLOTTERS=凝血剂
CIGARETTE BOX=香烟盒
CIVILIAN MEDKIT=民用医疗包
CSTM PILL=CSTM药片
HUNGER BUSTER=饱腹丸
PRESCRIBED MEDICATION=处方药
HIGH DOSE MEDICATION=高剂量药物
VOLUMEN=显影剂
SCIENTIFIC MEDKIT=科研医疗包
STEROIDS=类固醇
STIMPACK=兴奋剂
BAG OF VITAMINS=维生素包
A BAG OF GREENS.=一袋绿色药片。
BASEMENT KEY=地下室钥匙
BLUE BLOCK KEY=蓝区钥匙
COASTAL KEY=海岸钥匙
ELEVATOR KEY=电梯钥匙
FOREMAN KEY=工头钥匙
FUSE=保险丝
FUSE=保险丝
MILLER'S KEY=米勒的钥匙
SURFACE GATE KEY=地表大门钥匙
KNOT KEY=绳结钥匙
WHEEL KEY=轮形钥匙
KEY FRAGMENT=钥匙碎片
NAME PLATE=名牌
MASTER KEY=万能钥匙
OASIS GOODS KEY=绿洲货物钥匙
OLD KEY=旧钥匙
LEVER REPLACEMENT=替换拉杆
STATION MASTER KEY=警局万能钥匙
PRISON MASTER KEY=监狱万能钥匙
BLOOD STAINED KEY=血迹钥匙
SECURITY KEY=安保钥匙
TUNNEL KEY=隧道钥匙
UNDERHALLS KEY=地下大厅钥匙
SYRINGE=注射器
ADRENALINE=肾上腺素
GR-72K INJECTION=GR-72K注射剂
SMALL MORPHINE INJECTION=小型吗啡注射剂
MIRACLE DRUG=奇迹灵药
STAMINA-K INJECTION=体力-K注射剂
BATTERY PACK=电池组
ELEVATOR BUTTON=电梯按钮
HAZARD HELMET=危险防护头盔
HAZARD LEAD SUIT=铅衬危险防护服
HAZARD SUIT BODY=防护服主体
METAL ORNAMENT HEAD=金属装饰头
METAL ORNAMENT=金属装饰
METAL ORNAMENT POLE=金属装饰杆
PIPE (BEND)=弯管道
PIPE (T-JUNCTION)=三通管道
PIPE (STRAIGHT)=直管道
RUSTY COG=生锈齿轮
RECORD=录音盘
BRICK=砖块
FLARE=信号棒
LIGHTER=打火机
NAIL BOMB=钉刺炸弹
ROCK=石块
NAILED ROCK=钉刺石
SMALL EXPLOSIVE=小型炸药
MOLOTOV COCKTAIL=莫洛托夫鸡尾酒
AXE=斧头
AXE HANDLE=斧柄
BAT=球棒
BUTCHER KNIFE=屠刀
DOUBLE BARREL SHOTGUN=双管霰弹枪
GLASS SHIV=玻璃剃刀
HAMMER=锤子
HAMMER HANDLE=锤柄
HARPOON GUN=鱼叉枪
KNIFE=刀具
MEATHOOK=肉钩
METAL SHIV=金属剃刀
NAILED POLE=钉刺杆
NAILED STICK=钉刺短棍
P08=P08
PICKAXE=十字镐
POLE=长杆
REVOLVER=左轮手枪
SCISSORS=剪刀
SHOTGUN=霰弹枪
SLEDGEHAMMER=大锤
SMALL AXE=小斧
SMALL SLEDGEHAMMER=小锤
SMALL SPADE=小铲
A SHORT-HANDLED SPADE.=一把短柄铲。
SMG=冲锋枪
SPADE=铲子
LEAD PIPE=铅管
WRENCH=扳手
NAILED BAT=钉刺球棒
BURNT SCRAP SPEAR RAGGED=烧焦的粗糙废料长矛
NAILED ROCK SACK=钉石麻袋
REBAR CLUB=钢筋棍
REBAR=钢筋
REBAR POLE=钢筋杆
ROCK SACK=石袋
KNIFE SPEAR=刀矛
SCRAP MACHETE=废料砍刀
SCRAP SPEAR=废料长矛
SCRAP SPEAR RAGGED=粗糙废料长矛
CHAINED LEAD PIPE=链缠铅管
SERO-33 INJECTION=SERO-33注射剂
CORA'S BRACELET=科拉的手链
BOLT CUTTERS=断线钳
PUMP ROOM KEY=水泵房钥匙
SHOTGUN (MISSING PUMP)=霰弹枪(缺少护木)
SHOTGUN PUMP=霰弹枪护木
FIREARM COMPONENTS=枪械零件
RECORD SHARD=唱片碎片
GLUED RECORD=胶粘唱片
TAPED RECORD=胶带唱片
ORNAMENT TAPE=装饰胶带
THE SPLITTER=分裂者
HOOKSHIV=钩刃
SNIP 'N SMASH=剪砸器
RED COMPOUND=红色化合物
GREEN COMPOUND=绿色化合物
BLUE COMPOUND=蓝色化合物
COMPOUND SYRINGE (G+G)=化合物注射器(绿+绿)
COMPOUND SYRINGE (G+B)=化合物注射器(绿+蓝)
COMPOUND SYRINGE (R+B)=化合物注射器(红+蓝)
COMPOUND SYRINGE (R+R)=化合物注射器(红+红)
COMPOUND SYRINGE (G+R+R)=化合物注射器(绿+红+红)
COMPOUND SYRINGE (B+B+R)=化合物注射器(蓝+蓝+红)
COMPOUND SYRINGE (G+G+R)=化合物注射器(绿+绿+红)
PIPE CUTTER=切管器
CRAG SPIKE=峭壁尖刺
BUTCHER'S WRENCH=屠夫扳手
SCISSOR AXE=剪刀斧
RATTLE POLE=响尾杆
SCRAP AXE=废料斧
SACK=麻袋
RECORD: "80'S SYNTH"=唱片：《80年代合成乐》
RECORD: "CHOPIN"=唱片：《肖邦》
RECORD: "COOL JAZZ"=唱片：《酷派爵士》
RECORD: "VHS"=唱片：《录像带》
RECORD: "TANGO"=唱片：《探戈》
SMALL PICKAXE HEAD=小镐头
SMALL PICKAXE=小镐
BARBED REBAR AXE=带刺钢筋斧
BARBED REBAR ROCK=带刺钢筋石
BARBED BUTCHER WRENCH=带刺屠夫扳手
BARBED BUTCHER PIPE=带刺屠夫管子
(Hold) =(长按) 
Take =拿取
Letter =信件 
Crafting item=制作材料
Important item=重要物品